NO ./img/city1.xpm
SO ./img/city2.xpm
WE ./img/city3.xpm
EA ./img/city4.xpm

F 65,75,90
C 180,175,190

1111111111111111111111111
1000000000110000000000001
1011000001110000000000001
100100000000000000000000111111111      111
111111111011000001110000000000001      101
100000000011000001110111110011111      111
11111111111111011100000010001
11110111111111011101010010001
11000000110101011100000010001
10000000000000001100000010001
1000E000000000001101010010001
1100000111010101110101111000111
11110111 1110101 101111010001
11111111 1111111 111111111111

