NO ./img/wolf_yellow_stone.xpm
SO ./img/wolf_wood.xpm
WE ./img/wolf_stone.xpm
EA ./img/wolf_stone_tile.xpm
DO ./img/wood_door.xpm
M0 ./img/blue_snail_full.xpm
M1 ./img/blue_snail_half.xpm

F 63,51,41
C 43,41,35


1111111111111111111111111
1000000000110000000000001
1011000001110000000000001
10010000000000000000000011111111       111
1111D1111011000001110000000000001      101
100000000011000001110111111111111      111
111101D1111111011100000010001
111101D1111111011101010010001
11000000110101011100000010001
1000N000000000001100000010001
1000M000M00000001101010010001
1100000111010101111101111000111
11110111 1110101 101111010001
11111111 1111111 111111111111
